"a" = (/turf/simulated/floor/holospace,/area/template_noop)
"b" = (/obj/structure/table/glass,/turf/simulated/floor/holospace,/area/template_noop)
"g" = (/obj/structure/bed/chair/shuttle{dir = 8},/turf/simulated/floor/holospace,/area/template_noop)
"l" = (/obj/structure/table/glass/plass,/obj/item/clothing/head/helmet/space/skrell/white,/obj/item/clothing/head/helmet/space/void/scuba,/turf/simulated/floor/holospace,/area/template_noop)
"m" = (/obj/structure/table/glass,/obj/item/material/ashtray/plastic,/turf/simulated/floor/holospace,/area/template_noop)
"n" = (/obj/structure/bed/chair/shuttle/red{dir = 4},/turf/simulated/floor/holospace,/area/template_noop)
"o" = (/obj/item/plant_pot/random,/obj/structure/table/glass/plass,/turf/simulated/floor/holospace,/area/template_noop)
"p" = (/obj/structure/table/glass,/obj/item/device/synthesized_instrument/violin,/turf/simulated/floor/holospace,/area/template_noop)
"s" = (/obj/item/reagent_containers/food/grown/coffee,/obj/item/reagent_containers/food/grown/coffee,/obj/structure/table/glass/plass,/turf/simulated/floor/holospace,/area/template_noop)
"C" = (/obj/structure/window_frame/grille,/obj/structure/window/research,/obj/structure/table/glass/plass,/turf/simulated/floor/holospace,/area/template_noop)
"E" = (/obj/structure/bed/chair/shuttle{dir = 4},/turf/simulated/floor/holospace,/area/template_noop)
"G" = (/obj/machinery/light{dir = 1},/turf/simulated/floor/holospace,/area/template_noop)
"K" = (/obj/structure/bed/chair/shuttle/red,/turf/simulated/floor/holospace,/area/template_noop)
"M" = (/obj/machinery/door/window{name = "Bar"; req_one_access = list(25); base_state = "right"},/turf/simulated/floor/holospace,/area/template_noop)
"N" = (/obj/structure/table/glass,/obj/item/clothing/head/helmet/space/syndicate/green/dark,/obj/item/clothing/head/helmet/space/syndicate/green,/obj/item/clothing/head/helmet/space/syndicate/blue,/obj/item/clothing/head/helmet/space/syndicate,/turf/simulated/floor/holospace,/area/template_noop)
"O" = (/turf/simulated/wall{holodeck_compatible = 1},/area/template_noop)
"P" = (/obj/structure/bed/chair/shuttle/red{dir = 8},/turf/simulated/floor/holospace,/area/template_noop)
"R" = (/obj/structure/bed/chair/shuttle/black{dir = 8},/turf/simulated/floor/holospace,/area/template_noop)
"U" = (/obj/item/stool/bar,/turf/simulated/floor/holospace,/area/template_noop)
"Z" = (/obj/structure/table/glass/plass,/turf/simulated/floor/holospace,/area/template_noop)

(1,1,1) = {"
aaOaalZZOaaZO
aaOaaaaaMaasO
aUoaZaZaZUaZO
aUZaaaaaZUaaO
aaCZZZZZCaaaU
aaGUUUUUGaaaU
aaaaaaaaaaaaU
EbgaaaaaEbgaU
EmgaaaaaEmgaU
aaaaaaaaaaaaa
aRaaaaaaaKaaK
NpaaaaaanbPnb
"}
