"a" = (/turf/simulated/floor/reinforced,/area/template_noop)
"c" = (/turf/simulated/wall{holodeck_compatible = 1},/area/template_noop)
"d" = (/obj/machinery/light/small/red{dir = 1},/turf/simulated/floor/reinforced,/area/template_noop)
"r" = (/obj/structure/window_frame/grille,/turf/simulated/floor/reinforced,/area/template_noop)
"u" = (/obj/structure/window_frame/grille,/turf/simulated/floor/tiled/dark/mono,/area/template_noop)
"L" = (/obj/item/reagent_containers/food/grown/coffee,/obj/item/reagent_containers/food/grown/coffee,/turf/simulated/floor/reinforced,/area/template_noop)
"R" = (/obj/effect/holodeck_effect/carp,/turf/simulated/floor/reinforced,/area/template_noop)

(1,1,1) = {"
rrcaaaaacrrrc
aacaaaaaraaLc
aauaaaaaraaac
RauaaaaaraRac
aarrrrrrraaar
aaadaaadaaaar
aaaaaaaaaaaar
aaaaaRaaaRaar
aRaaaaaaaaaar
aaaaaaaaaaaar
aaaaaaaaaaRar
aaaarrraaaaaa
"}
