"a" = (/obj/structure/table/darkwood_reinforced,/turf/simulated/floor/natural/snow,/area/template_noop)
"b" = (/obj/effect/floor_decal/snow,/obj/effect/floor_decal/snowedge{dir = 9},/obj/effect/floor_decal/snowedge,/turf/simulated/floor,/area/template_noop)
"c" = (/obj/structure/table/darkwood_reinforced,/obj/item/material/ashtray/glass,/turf/simulated/floor/natural/snow,/area/template_noop)
"d" = (/obj/effect/floor_decal/snow,/obj/effect/floor_decal/snowedge{dir = 1},/obj/effect/floor_decal/snowedge{dir = 10},/turf/simulated/floor,/area/template_noop)
"e" = (/obj/structure/window_frame/indestructible/grille,/obj/effect/floor_decal/snow,/turf/simulated/floor,/area/template_noop)
"f" = (/obj/effect/floor_decal/snow,/obj/effect/floor_decal/snowedge{dir = 6},/turf/simulated/floor,/area/template_noop)
"g" = (/obj/structure/bed/chair/comfy/black,/turf/simulated/floor/natural/snow,/area/template_noop)
"h" = (/obj/item/clothing/head/ushanka/tcc,/obj/item/clothing/suit/storage/hooded/wintercoat/security,/obj/item/clothing/head/helmet/space/santahat,/obj/item/clothing/suit/space/santa,/obj/structure/table/darkwood_reinforced,/turf/simulated/floor/natural/snow,/area/template_noop)
"i" = (/obj/structure/table/darkwood_reinforced,/obj/item/reagent_containers/vessel/flask/vacuumflask{pixel_y = 4},/turf/simulated/floor/natural/snow,/area/template_noop)
"j" = (/obj/structure/bed/couch/left/blue{dir = 4},/turf/simulated/floor/natural/snow,/area/template_noop)
"k" = (/obj/effect/floor_decal/snow,/obj/effect/floor_decal/snowedge{dir = 9},/obj/effect/floor_decal/snowedge{dir = 4},/turf/simulated/floor,/area/template_noop)
"l" = (/obj/structure/bed/couch/right/blue{dir = 4},/turf/simulated/floor/natural/snow,/area/template_noop)
"m" = (/obj/structure/flora/bush,/obj/effect/floor_decal/snow,/obj/effect/floor_decal/snowedge{dir = 6},/turf/simulated/floor,/area/template_noop)
"n" = (/obj/structure/bed/chair/comfy/black{dir = 8},/turf/simulated/floor/natural/snow,/area/template_noop)
"o" = (/obj/effect/floor_decal/snow,/obj/effect/floor_decal/snowedge,/obj/effect/floor_decal/snowedge{dir = 1},/turf/simulated/floor,/area/template_noop)
"p" = (/obj/item/stool/bar,/obj/effect/floor_decal/snow,/obj/effect/floor_decal/snowedge,/obj/effect/floor_decal/snowedge{dir = 1},/turf/simulated/floor,/area/template_noop)
"q" = (/obj/effect/floor_decal/snow,/obj/effect/floor_decal/snowedge{dir = 1},/obj/effect/floor_decal/snowedge,/obj/structure/bed/couch/left/blue{dir = 8},/turf/simulated/floor,/area/template_noop)
"r" = (/obj/structure/flora/ausbushes/fullgrass,/turf/simulated/floor/natural/snow,/area/template_noop)
"s" = (/obj/machinery/light{dir = 1},/turf/simulated/floor/natural/snow,/area/template_noop)
"t" = (/obj/effect/floor_decal/snow,/obj/effect/floor_decal/snowedge{dir = 1},/obj/structure/bed/couch/right/blue{dir = 4},/turf/simulated/floor,/area/template_noop)
"u" = (/obj/structure/bed/couch/right/blue{dir = 8},/turf/simulated/floor/natural/snow,/area/template_noop)
"v" = (/obj/structure/bed/couch/left/blue{dir = 8},/turf/simulated/floor/natural/snow,/area/template_noop)
"w" = (/obj/structure/table/darkwood_reinforced,/obj/item/reagent_containers/vessel/flask/vacuumflask{pixel_y = 4},/obj/effect/floor_decal/snow,/obj/effect/floor_decal/snowedge{dir = 1},/turf/simulated/floor,/area/template_noop)
"x" = (/obj/structure/flora/bush,/turf/simulated/floor/natural/snow,/area/template_noop)
"y" = (/turf/simulated/floor/natural/snow,/area/template_noop)
"z" = (/turf/simulated/wall{holodeck_compatible = 1},/area/template_noop)
"A" = (/obj/item/plant_pot/random,/obj/structure/table/darkwood_reinforced,/turf/simulated/floor/natural/snow,/area/template_noop)
"B" = (/obj/effect/floor_decal/snow,/obj/effect/floor_decal/snowedge{dir = 10},/turf/simulated/floor,/area/template_noop)
"C" = (/obj/machinery/door/window{name = "Bar"; req_one_access = list(25); base_state = "right"},/obj/effect/floor_decal/snow,/obj/effect/floor_decal/snowedge{dir = 5},/turf/simulated/floor,/area/template_noop)
"D" = (/obj/item/stool/bar,/obj/effect/floor_decal/snow,/obj/effect/floor_decal/snowedge{dir = 5},/turf/simulated/floor,/area/template_noop)
"E" = (/obj/effect/floor_decal/snow,/obj/machinery/light{dir = 1},/turf/simulated/floor,/area/template_noop)
"F" = (/obj/effect/floor_decal/snow,/obj/effect/floor_decal/snowedge{dir = 4},/turf/simulated/floor,/area/template_noop)
"G" = (/obj/effect/floor_decal/snow,/obj/effect/floor_decal/snowedge{dir = 1},/turf/simulated/floor,/area/template_noop)
"H" = (/obj/item/stool/bar,/obj/effect/floor_decal/snow,/obj/effect/floor_decal/snowedge{dir = 1},/turf/simulated/floor,/area/template_noop)
"I" = (/obj/effect/floor_decal/snow,/obj/effect/floor_decal/snowedge{dir = 8},/turf/simulated/floor,/area/template_noop)
"J" = (/obj/item/stool/bar,/obj/effect/floor_decal/snow,/turf/simulated/floor,/area/template_noop)
"K" = (/obj/structure/flora/ausbushes/pointybush,/turf/simulated/floor/natural/snow,/area/template_noop)
"L" = (/obj/item/stool/bar,/obj/effect/floor_decal/snow,/obj/effect/floor_decal/snowedge{dir = 9},/turf/simulated/floor,/area/template_noop)
"N" = (/obj/structure/bed/chair/comfy/black{dir = 4},/turf/simulated/floor/natural/snow,/area/template_noop)
"O" = (/obj/structure/table/darkwood_reinforced,/obj/item/clothing/head/ushanka,/obj/item/clothing/head/ushanka,/obj/item/clothing/suit/storage/hooded/wintercoat,/obj/item/clothing/suit/storage/hooded/wintercoat,/obj/item/device/synthesized_instrument/trumpet,/turf/simulated/floor/natural/snow,/area/template_noop)
"P" = (/obj/item/reagent_containers/food/grown/coffee,/obj/item/reagent_containers/food/grown/coffee,/obj/structure/table/darkwood_reinforced,/turf/simulated/floor/natural/snow,/area/template_noop)
"R" = (/obj/structure/flora/tree/pine,/turf/simulated/floor/natural/snow,/area/template_noop)
"S" = (/obj/effect/floor_decal/snow,/obj/effect/floor_decal/snowedge,/obj/structure/bed/couch/left/blue{dir = 4},/turf/simulated/floor,/area/template_noop)
"T" = (/obj/effect/floor_decal/snow,/obj/effect/floor_decal/snowedge{dir = 9},/turf/simulated/floor,/area/template_noop)
"U" = (/obj/effect/floor_decal/snow,/obj/effect/floor_decal/snowedge,/turf/simulated/floor,/area/template_noop)
"V" = (/obj/item/stool/bar,/turf/simulated/floor/natural/snow,/area/template_noop)
"W" = (/obj/structure/table/darkwood_reinforced,/obj/item/material/ashtray/glass,/obj/effect/floor_decal/snow,/obj/effect/floor_decal/snowedge{dir = 6},/obj/effect/floor_decal/snowedge,/turf/simulated/floor,/area/template_noop)
"X" = (/obj/structure/flora/tree/dead/deadtree_0,/turf/simulated/floor/natural/snow,/area/template_noop)
"Y" = (/obj/structure/flora/grass/both,/turf/simulated/floor/natural/snow,/area/template_noop)
"Z" = (/obj/effect/floor_decal/snow,/turf/simulated/floor,/area/template_noop)

(1,1,1) = {"
yyzyyRhyzyxaz
yyzYBooGCyyPz
YVAyayaFaVyaz
bDadooomaVyyz
yIeaaaaaeyyyV
yBEHppHDsKyYL
yyBfyyBFyyyTJ
livKykyItwqZJ
jcuyYZoUSWuIJ
yyyyTfyyyyyBU
ynyyByyYygyrg
OaXxyyyyNanNa
"}
